
Forgot Your Password=Olvide mi contrasena
Create an account=crea una cuenta
Sign In=Registrarse
Choose language=elige lengua
Spanish=Espanol
Logout=Cerrar sesion
Insert manually=insertar manualmente
Search=buscar
Upload=subir
Client/Admin=Cliente/Administrador
Email/Userid=Email/ID de usuario
firstname=nombre de pila
lastname=apellido
email=correo electronico
password=contrasena
confirm password=Confirmar contrasena
Reset=Reiniciar
Done=hecho
input firstname=datos de entrada
Password do not match=La contrasena no coincide
Password is too short=La contrasena es demasiado corta
Input password=Contrasena de entrada
Email format not valid=formato de correo electronico no es valida
input email=correo electronico de entrada
input lastname=apellido de entrada
input firstname=Nombre de entrada
Age=anos 
Stage of Change=Etapa de Cambio
Symptoms and Disorders=Los sintomas y el trastorno
Psychological Treatment=El tratamiento psicologico
Evidence Level=Nivel de evidencia
Basis for Evidence=Fundamentos de las pruebas
Welcome=Bienvenido 
Search=Buscar
Main=Principal
Updates=actualizaciones
Check here for new password=
Pincha aquí para ver la nueva contrasena
Update= Actualizar
Delete Account=Borrar cuenta
Current Password=contrasena actual
New Passowrd=nueva passowrd
First Name=Nombre de pila
Last Name=Apellido
User Id=Identidad de usuario
FirstName can't be empty=Primer nombre no puede estar vacio
LastName can't be empty=Apellido no puede estar vacia
UserName can't be empty=Nombre de usuario no puede estar vacía
Please give a current password in oder to update=Por favor, dar una contrasena actual en oder para actualizar
I think your password has more characters=Creo que la contraseña tiene mas caracteres
Current password does not exist=La contrasena actual no existe
Update was succeful=Actualizacion se ha realizado succeful
Input current password in order to delete account=contrasena actual de entrada con el fin de eliminar la cuenta
New Password can't be empty=Nueva contrasena no puede estar vacia
Update was succeful including your new password=Actualizacion se ha realizado succeful incluyendo su nueva contrasena
Page=pagina
Admin Section=Seccion de administracion
count=contar
Count=contar
question=pregunta
Question=pregunta
Updates=actualizaciones
Add admins=Anadir los administradores
clients=cliente
Feedback=retroalimentacion
Feedback Answers=Las respuestas de retroalimentacion

Welcome=Bienvenido
Admin Section=Seccion de administracion
Firstname=nombre de pila
Lastname=apellido
Email=Email
Act/Deact=Act / Desact
date=fecha
Check for Addmin=Compruebe si hay Addmin
Insert=insertar
Search through for names=Realice una busqueda entre los nombres
delete=borrar
show=espectaculo
add=anadir
Add=anadir
User= usuario
Search through the database below. You can also edit and delete a row or column=
insert into database below=
This upload engine accepts only excel files with the extension xlsx. When uploading make sure you have 7 columns on your excel sheet, ie. age, stage of change , symptoms and disorders, psychological treatment, evidence level and basis for evidence. You don\'t have to give titles such as age for the first column or symptoms and disorders for the third column.Note! these steps are done on your excel sheet. when done you upload it here. :)=Este motor de subida solo acepta archivos de Excel con la extensión .xlsx . Al subir asegúrese de que tiene 7 columnas en la hoja de Excel , es decir . la edad, la etapa de cambio , sintomas y trastornos, tratamiento psicologico , nivel de evidencia y la base de pruebas . Usted no tiene que dar títulos como la edad de la primera columna o síntomas y trastornos de la tercera column.Note ! estos pasos se realizan en la hoja de calculo de Excel. cuando haya terminado de cargar aqui. :)




